***********
*10  20 *****
*  *  *****
*  *   * **
 2 ********
*  ********
*4*********
*   6  8 **
***********