(1,1)
10 10
*	*	*	*	*	*	*	*	*	*
*		*						*	*
*		*		*	*	10			*
*	20	*			*	*			*
*						*			*
*	*	*	15		*	*	*		*
*		*	*		*		*	*	*
*							*	4	*
*		*		*					*
*	*	*	*	*	*	*	*	*	*
