*****
* 10 *
* *  
* ***
* 20 *
*****