**********
* *     **
* * **10  *
*20*  **  *
*     *  *
***15 *** *
* ** * ***
*      *4*
* * *    *
******* **
